1111111111111111111111
1E00000000C0001C000001
1000000000C00011101001
10000100CCGCC011001001
1P0001100CC01111100001
1000C1111CC0001100C001
1000C0111C000000000001
1000000C110000100000C1
1000000000001100000011
1111111C00000110000001
1110000000001110000001
111000000C01111000C001
1111111111111111111111
