11111111111
1C000E00001
1000P011001
10000001111
11111111111
