1111111
1C00001
1000P01
1000001
1111111
