1111111111111111111111
1E0000000000000C000001
1000000000000000101001
1000010000001011001001
100001100C000111100001
1000C1111C00001100C001
1000C0111C111000000001
1000000C000000100000C1
1000000000000110000001
1111110C00000110000001
1110000000001110000001
111000000C01111000C001
111000000C01111000C001
111000000C01111000C001
111000000C01111000C001
111000000C01111000C001
111000000C01111000C001
111000000C01111000C001
111000000C01111000C001
1111111111111111111111
