111111111111
1C00010101E1
1010P0111001
111110000001
111111111111
