1111111
1C00E01
10X0P01
1000001
1111111